522585978       	<522585978@qq.com>
Aaron Giachett  	<agiachett@gmail.com>
Adam Behr       	<behr.adam00@gmail.com>
Alan Tyndall    	<atvpizza@aol.com>
Anton           	<chrisophylacks@gmail.com>
Bart Poynor     	<bartpoynor@gmail.com>
Ben Cox         	<ncbencox@gmail.com>
Bobby Semler    	<semlerbobby@gmail.com>
Brad Connor     	<bradjconnor@hotmail.com>
Brett Caramalis 	<caramalisbrett@gmail.com>
Bruce Gitter    	<bdgitter@aol.com>
Chad Adams      	<Ca4u@hotmail.com>
Chad Truax      	<chadtruax1@gmail.com>
Chris Brown     	<cbrown7584@gmail.com>
Chris Combs     	<chrisdcombs@yahoo.com>
Chris DePiano   	<Cdeeps318@gmail.com>
Chris Honor√©    	<cfhonore@gmail.com>
Chris Smith     	<chsmith13@outlook.com>
Christian Dixon 	<Apexpirate@yahoo.com>
Christine Wilson	<hipaachick@yahoo.com>
Chuck           	<chucktheman_2000@yahoo.com>
Corey Reid      	<corey_reid@hotmail.com>
Craig Hill      	<chill123.ch@gmail.com>
Daniel Feinberg 	<dfeinber@gmail.com>
Daniel McCoy    	<Referee_Daniel_Mccoy@yahoo.com>
Darrel Moser    	<darrel.moser1@gmail.com>
Darryl Robinson 	<darrylr35@gmail.com>
Dave Browning   	<dbrownin@yahoo.com>
Dave Wall       	<dhwall@outlook.com>
David DeHart    	<dbdehart@aol.com>
David J Beery   	<davidjbeery@gmail.com>
David Pass      	<d.pass.unc@gmail.com>
David Wyatt     	<Wyatt.David@gmail.com>
Dyquise         	<Dyquise@gmail.com>
Ed Denault      	<edwarddenault@outlook.com>
Emma Raisel     	<emma.rasiel@duke.edu>
Eric Wilson     	<eric.wilson@webbasix.com>
Gary Colen      	<garycolen@gmail.com>
Gautam Khandelwal	<gkhandel@hotmail.com>
George Kuchenreuther	<gkuchenreuther@myeyedr.com>
Greg Boone      	<boonegb@gmail.com>
Heather Dennis  	<hrd244@gmail.com>
James Zewe      	<Jameszewe@gmail.com>
Jan Atkinson    	<janatkinson.law@gmail.com>
Jason Douglas   	<jason@jasondouglasrealty.com>
Jason Hartford  	<jasonhartford25@gmail.com>
Jason Tant      	<jaybear500@gmail.com>
Jay Hauser      	<ArizonaJay@gmail.com>
Jeff Baldino    	<plumrunner@gmail.com>
Jeff Craver     	<jeffcraver1@att.net>
Jeff Yiannaki   	<Jyiannaki@gmail.com>
Jim Cole        	<james.cole@duke.edu>
Joe Snyder      	<jeswcu@gmail.com>
Johnny May      	<johnny.may@nestrealty.com>
Johnny Wehmann  	<jwehmann@gmail.com>
Josh Walker     	<jmw1664@gmail.com>
Joshua Stubbolo 	<Josh@familylegacync.com>
Keshav K. Srinivasan	<keshav.k.srinivasan@gmail.com>
Ketan Lad       	<ketanblad@gmail.com>
Kris            	<Topher8644@gmail.com>
Kurt Pearson    	<kepearson@triad.rr.com>
Larry Kall      	<kalllarry@gmail.com>
Leon Copeland   	<leonhcopeland@gmail.com>
Marc Casale     	<marc.casale@gmail.com>
Marco Schletz   	<marco.schletz@gmail.com>
Mark Addison    	<maddison36@gmail.com>
Mark Mdme       	<mark.mdme@juno.com>
Martin Stevens  	<martintstevens97@gmail.com>
Massoud Monazah 	<mmonazah@gmail.com>
Matt Bello      	<mbellous@yahoo.com>
Matt Buffington 	<tmbuffington@gmail.com>
Matt Kerekes    	<Mrkerekes15@gmail.com>
Mayur           	<mayurananth@yahoo.com>
Mehul Shah      	<Amehul99@yahoo.com>
Michael Blake   	<mtblake000@yahoo.com>
Michael Klein   	<mklein1977@gmail.com>
Michael Lemanski	<Lemanski@newsouthventures.com>
Michael Peters  	<michael00peters@gmail.com>
Michael Pierce  	<map24pma@yahoo.com>
Michael Timmons 	<michael.timmons@protonmail.com>
Michael Ventola 	<sccgolfproff@gmail.com>
Mike Jones      	<mikelj80@gmail.com>
Mike Rice       	<mrice@paraclerealty.com>
Morris Weinberger	<mweinber@email.unc.edu>
Nathan Huening  	<nathan.huening@gmail.com>
Nick Mandikos   	<Nickmandikos@gmail.com>
Noah McEachern  	<noahmce@outlook.com>
Pat Spampinato  	<spampinp@gmail.com>
Pat Wray        	<Pwray1969@gmail.com>
Paul Banza      	<pbanza5@gmail.com>
Paul O'Neil     	<paulmoneil35@gmail.com>
Pete Makowenskyj	<Murg40@hotmail.com>
Peter Priest    	<phpriest7399@gmail.com>
Peter Robson    	<factor1783@gmail.com>
Rajeev Rajendran	<rajeev.rajendran@gmail.com>
Rich Fountain   	<rfountain1011@gmail.com>
Rob Wainwright  	<rmw8478@yahoo.com>
Robert Girardin 	<Rob.girardin@gmail.com>
Ron Absher      	<ron.absher@gmail.com>
Roy Twiddle     	<royunc@aol.com>
Russell Schnell 	<rdschnell@bloomer.net>
Ryan Shaughnessy	<rjshaughnessy@aol.com>
Sai Kushan      	<Saikushal08@gmail.com>
Sam Shamseldin  	<sam@catatac.com>
Shane Port      	<shanemport@gmail.com>
Sharod Baldwin  	<S.baldwin496.bb@gmail.com>
Steve Hand      	<trianglebni@yahoo.com>
Steve Monroe    	<monroe@us.ibm.com>
TheDeezer1      	<sdees@live.com>
Tim Miller      	<BufBillsFan@gmail.com>
Tim Niles       	<timniles@gmail.com>
Tom Reynolds    	<tgreynolds8@live.com>
Trey Ball       	<tball73@gmail.com>
Vik Kapoor      	<vkap@hotmail.com>
Vince Picciano  	<v524picciano@yahoo.com>
Weihan Chan     	<weiyan8@gmail.com>
Zach Sloane     	<zsloane@nc.rr.com>
